        
        
        NO ./assets/wall/brick-1l.png
        
        SO ./assets/wall/brick-2l.png
        
        WE ./assets/wall/brick-2d.png

        EA ./assets/wall/brick-1d.png

        F 220,100,0
C 225,30,0
    
        xxxxx

        1111111111111111111111111
        1000000000110000000000001
        1011000001110000000000001
        1001000000000000000000001
111111111011000001110000000000001
100000000011000001110111111111111
11110111111111011100000010001
11110111111111011101010010001
11000000110101011100000010001
10000000000000001100000010001
10000000000000001101010010001
11000001 1010101111101111110N0111
111101111110101 101111010001
11111111 1111111 111111111111