NO       ./textures/waterfall.png

SO ./textures/house.png

WE ./textures/forest.png

EA ./textures/field.png

C 100,149,237

F      107,90,54











        1111111111111111111111111
        1111111100110000000000001
        1011000001110000000000W01
        1001000000000000000000001
1111111110110000011100000000000011111111111
100000000011000001110111111111111
11110111111111011100000010001
11110111111111011101010010001
11000000110101011000000010001
10000000000000001100010010001
1000000000000000110101001000111111
11000001110101011111011110011
11110111 1110101 101111010001
11111111 1111111 111111111111

