       C 2,2,255

NO       ./textures/waterfall.png
       F 255,255,255

SO ./textures/house.png







WE ./textures/forest.png









EA ./textures/field.png









       1111111111111111111111111
       1000000000110000000000001
       1011000001110000000000001
       10010000000000000000000011
111111111011000001110000000000001
000000000110000011101111111E11111
1111111111111111111111111111






11111111111111111111111111111
11110111111111011101010010001
11000000110101011100000010001
10000000000000001100000010001
10000000000000001101010010001
11000001110101011111011110N0111
11110111 1110101 101111010001
11111111 1111111 111111111111

