
NO ./assets/textures/Horrorlist.png



SO ./assets/textures/Horrorlist.png

WE ./assets/textures/Horrorlist.png


EA ./assets/textures/Horrorlist.png



F 31, 33, 32
C 82, 66, 68

        1111111111111111111111111
        1000000000110000000000001
        1011000001110000000000001
        1001000000000000000000001
11111111101100N001110000000000001
10000000001100000111011111111111111111111111111111111111111111111111111111111111111111111111111111111111111111111111111111111
111101111111110000000000000000000000000000000000000000000000000000000000000000000000000000000000000000000000000000000000000001  
11110111111111011101010000000000000000000000000000000000000000000000000000000000000000000000000000000000000000000000000000001 
11000000110101011100000000000000000000000000000000000000000000000000000000000000000000000000000000000000000000000000000000001    
10000000000000000000000000000000000000000000000000000000000000000000000000000000000000000000000000000000000000000000000000001     
100000000000000011010100100011111111111111111111111111111111111111111111111111111111111111111111111111111111111111111111111111   
1100000111010101110101101000111  
11110111 1110101 101111010001    
11111111 1111111 111111111111    





